LABIRINTO 1
1,0,1,1,1,1,1,1,1,1,1
1,0,0,0,0,0,0,0,1,0,1
1,1,1,0,1,1,1,0,1,0,1
1,0,0,0,1,0,1,0,0,0,1
1,1,1,1,1,0,1,1,1,0,1
1,0,0,0,0,0,0,0,1,0,1
1,0,1,1,1,1,1,0,1,0,1
1,0,1,0,0,0,0,0,1,0,1
1,0,1,0,1,1,1,1,1,0,1
1,0,1,0,0,0,0,0,1,0,1
1,0,1,1,1,1,1,0,1,0,1
1,0,0,0,0,0,1,0,0,0,1
1,1,1,1,1,0,1,1,1,1,1
1,0,1,0,0,0,1,0,0,0,1
1,0,1,0,1,1,1,0,1,0,1
1,0,1,0,1,0,0,0,1,0,1
1,0,1,0,1,0,1,0,1,1,1
1,0,0,0,1,0,1,0,0,0,1
1,0,1,1,1,1,1,0,1,0,1
1,0,0,0,0,0,1,0,1,0,1
1,1,1,1,1,0,1,0,1,0,1
1,0,0,0,1,0,1,0,1,0,1
1,0,1,1,1,0,1,1,1,0,1
1,0,0,0,1,0,1,0,0,0,1
1,1,1,0,1,0,1,0,1,0,1
1,0,0,0,1,0,1,0,1,0,1
1,0,1,1,1,0,1,0,1,0,1
1,0,0,0,1,0,0,0,1,0,1
1,0,1,0,1,1,1,1,1,0,1
1,0,1,0,0,0,1,0,0,0,1
1,0,1,1,1,0,1,0,1,1,1
1,0,1,0,1,0,1,0,0,0,1
1,0,1,0,1,0,1,1,1,0,1
1,0,0,0,1,0,0,0,0,0,1
1,1,1,1,1,1,1,1,1,0,1

LABIRINTO 2
1,0,1,1,1,1,1,1,1,1,1
1,0,0,0,0,0,0,0,0,0,1
1,0,1,0,1,1,1,1,1,0,1
1,0,1,0,0,0,0,0,1,0,1
1,0,1,1,1,1,1,0,1,0,1
1,0,0,0,1,0,0,0,1,0,1
1,1,1,1,1,0,1,1,1,0,1
1,0,0,0,0,0,1,0,0,0,1
1,0,1,1,1,1,1,0,1,1,1
1,0,1,0,1,0,1,0,1,0,1
1,0,1,0,1,0,1,0,1,0,1
1,0,0,0,1,0,1,0,1,0,1
1,1,1,1,1,0,1,0,1,0,1
1,0,0,0,1,0,0,0,1,0,1
1,0,1,0,1,0,1,1,1,0,1
1,0,1,0,0,0,1,0,0,0,1
1,0,1,1,1,1,1,1,1,0,1
1,0,0,0,0,0,0,0,0,0,1
1,1,1,1,1,1,1,1,1,0,1
1,0,0,0,0,0,1,0,0,0,1
1,1,1,1,1,0,1,0,1,1,1
1,0,0,0,0,0,1,0,0,0,1
1,0,1,1,1,1,1,1,1,0,1
1,0,0,0,0,0,0,0,1,0,1
1,0,1,1,1,1,1,0,1,0,1
1,0,1,0,0,0,1,0,1,0,1
1,0,1,1,1,0,1,0,1,0,1
1,0,0,0,0,0,1,0,1,0,1
1,1,1,1,1,0,1,0,1,0,1
1,0,1,0,0,0,1,0,1,0,1
1,0,1,0,1,1,1,0,1,0,1
1,0,1,0,1,0,0,0,1,0,1
1,0,1,0,1,0,1,1,1,0,1
1,0,0,0,1,0,0,0,0,0,1
1,1,1,1,1,1,1,1,1,0,1

LABIRINTO 3
1,0,1,1,1,1,1,1,1,1,1
1,0,0,0,0,0,0,0,1,0,1
1,0,1,1,1,0,1,0,1,0,1
1,0,0,0,1,0,1,0,0,0,1
1,1,1,0,1,0,1,1,1,0,1
1,0,0,0,1,0,1,0,1,0,1
1,0,1,1,1,0,1,0,1,0,1
1,0,1,0,0,0,1,0,0,0,1
1,0,1,0,1,1,1,0,1,1,1
1,0,1,0,1,0,0,0,1,0,1
1,0,1,0,1,0,1,1,1,0,1
1,0,1,0,1,0,0,0,0,0,1
1,0,1,0,1,1,1,1,1,1,1
1,0,1,0,0,0,0,0,0,0,1
1,0,1,1,1,1,1,1,1,0,1
1,0,0,0,1,0,0,0,0,0,1
1,1,1,0,1,0,1,1,1,1,1
1,0,1,0,1,0,1,0,0,0,1
1,0,1,0,1,0,1,0,1,0,1
1,0,0,0,1,0,0,0,1,0,1
1,0,1,1,1,1,1,1,1,0,1
1,0,1,0,0,0,1,0,0,0,1
1,0,1,0,1,0,1,0,1,1,1
1,0,1,0,1,0,0,0,1,0,1
1,1,1,0,1,1,1,1,1,0,1
1,0,0,0,1,0,0,0,1,0,1
1,0,1,0,1,0,1,0,1,0,1
1,0,1,0,1,0,1,0,0,0,1
1,0,1,0,1,0,1,1,1,1,1
1,0,1,0,1,0,0,0,0,0,1
1,0,1,1,1,1,1,1,1,0,1
1,0,1,0,0,0,0,0,1,0,1
1,0,1,0,1,0,1,1,1,0,1
1,0,0,0,1,0,0,0,0,0,1
1,1,1,1,1,1,1,1,1,0,1

LABIRINTO 4
1,0,1,1,1,1,1,1,1,1,1
1,0,0,0,0,0,0,0,1,0,1
1,0,1,1,1,1,1,0,1,0,1
1,0,0,0,0,0,1,0,0,0,1
1,0,1,1,1,0,1,1,1,0,1
1,0,0,0,1,0,1,0,1,0,1
1,1,1,1,1,0,1,0,1,0,1
1,0,0,0,0,0,1,0,1,0,1
1,1,1,1,1,1,1,0,1,0,1
1,0,0,0,0,0,1,0,0,0,1
1,1,1,1,1,0,1,0,1,1,1
1,0,0,0,0,0,1,0,0,0,1
1,0,1,1,1,1,1,1,1,0,1
1,0,1,0,0,0,0,0,1,0,1
1,0,1,0,1,0,1,1,1,0,1
1,0,1,0,1,0,0,0,1,0,1
1,0,1,0,1,1,1,0,1,0,1
1,0,1,0,0,0,1,0,0,0,1
1,0,1,1,1,0,1,1,1,1,1
1,0,0,0,1,0,1,0,0,0,1
1,0,1,1,1,0,1,1,1,0,1
1,0,0,0,1,0,0,0,0,0,1
1,0,1,0,1,1,1,1,1,0,1
1,0,1,0,0,0,1,0,0,0,1
1,0,1,0,1,1,1,0,1,1,1
1,0,1,0,0,0,0,0,1,0,1
1,0,1,1,1,1,1,1,1,0,1
1,0,1,0,1,0,0,0,0,0,1
1,0,1,0,1,0,1,1,1,0,1
1,0,1,0,0,0,0,0,1,0,1
1,0,1,1,1,1,1,1,1,0,1
1,0,1,0,0,0,1,0,0,0,1
1,0,1,0,1,0,1,0,1,0,1
1,0,0,0,1,0,0,0,1,0,1
1,1,1,1,1,1,1,1,1,0,1

LABIRINTO 5
1,0,1,1,1,1,1,1,1,1,1
1,0,0,0,0,0,0,0,0,0,1
1,1,1,0,1,1,1,1,1,0,1
1,0,0,0,1,0,0,0,0,0,1
1,0,1,1,1,0,1,1,1,1,1
1,0,1,0,0,0,0,0,1,0,1
1,0,1,1,1,1,1,0,1,0,1
1,0,1,0,0,0,1,0,1,0,1
1,0,1,1,1,0,1,0,1,0,1
1,0,0,0,1,0,1,0,0,0,1
1,0,1,1,1,0,1,1,1,0,1
1,0,0,0,1,0,0,0,1,0,1
1,0,1,0,1,1,1,0,1,1,1
1,0,1,0,0,0,1,0,0,0,1
1,0,1,0,1,1,1,1,1,0,1
1,0,1,0,1,0,0,0,0,0,1
1,0,1,0,1,0,1,1,1,1,1
1,0,1,0,1,0,0,0,1,0,1
1,1,1,0,1,1,1,0,1,0,1
1,0,0,0,1,0,0,0,1,0,1
1,0,1,1,1,0,1,1,1,0,1
1,0,0,0,0,0,1,0,0,0,1
1,0,1,1,1,1,1,0,1,0,1
1,0,0,0,1,0,0,0,1,0,1
1,1,1,0,1,0,1,1,1,0,1
1,0,1,0,0,0,1,0,0,0,1
1,0,1,1,1,1,1,0,1,1,1
1,0,0,0,0,0,1,0,0,0,1
1,0,1,0,1,1,1,1,1,0,1
1,0,1,0,0,0,1,0,0,0,1
1,0,1,1,1,0,1,0,1,1,1
1,0,1,0,1,0,1,0,1,0,1
1,0,1,0,1,0,1,0,1,0,1
1,0,0,0,1,0,0,0,0,0,1
1,1,1,1,1,1,1,1,1,0,1

